Marie	Bizier
Camille	Blache
Léa	Blais
Manon	Blaise
Chloé	Blan
Laura	Blanc
Julie	Blanchard
Sarah	Blanche
Pauline	Blanche
Mathilde	Blanchet
Marine	Blanchette
Emma	Bland
Marion	Blandin
lucie	Blasier
Anaïs	Bleau
Océane	Blier
Justine	Blois
Morgane	Blond
Clara	Blondeau
Charlotte	Blondin
Juliette	Blouin
Emilie	Bloyer
Lisa	Bobier
Mélanie	Boche
Elodie	Bodin
Claire	Bodine
Inès	Body
margaux	Bohen
Alice	Boicourt
Amandine	Boileau
Audrey	Boire
Louise	Bois
Noémie	Boisclair
Clémence	Boisse
Maéva	Boisseau
Melissa	Boisselle
Amélie	Boisvert
Eva	Constantin
Caroline	Constantineau
Céline	Contant
Célia	Conte
Fanny	Conte
Elise	Contee
Sophie	Conter
Margot	Contois
Elisa	Coppin
Aurélie	Corbeil
Jade	Corbin
Estelle	Corby
Romane	Cordes
Jeanne	Cordier
ophélie	Cordon
Laurine	Cordonnier
Alexandra	Cormier
Valentine	Corne
Solène	Corneau
lola	Dalin
Coralie	Dallaire
Laëtitia	Dally
Alexia	Damas
Aurore	Damboise
Cécile	Dambrose
Alicia	Dameron
Zoé	Damery
Agathe	Damian
Julia	Damien
Anna	Dandurand
Emeline	Dane
Léna	Danger
Laurie	Danger
Lou	Danger
Nina	Dangler
coline	Danis
jessica	Danis
Maëlle	Danis
elsa	Danna
Lucile	Danos
Laure	Dansereau
Salomé	Dant
Axelle	Dantin
Andréa	Danton
Charlène	Daoust
gaelle	Daquin
helene	Darbonne
Clementine	Dardenne
Victoria	Darensbourg
myriam	Fregeau
éloïse	Fremin
heloise	Fremont
Cindy	Frenier
Marina	Frere
Cassandra	Freson
sara	Friant
Carla	Frigon
Ambre	Friloux
ludivine	Frison
anaelle	Frisque
sabrina	Fron
Angélique	Fruge
Thomas	Gaspar
nicolas	Gaspard
Julien	Gasque
QUENTIN	Gast
Maxime	Gastineau
Alexandre	Gaston
Antoine	Gaubert
Kevin	Gaudet
clement	Gaudin
Romain	Gaudreau
Pierre	Gaudreault
lucas	Gaulin
Florian	Gault
GUILLAUME	Gaumond
valentin	Gauthier
Jérémy	Gautier
hugo	Gautreau
Alexis	Gautreaux
anthony	Gauvin
Theo	Gauvreau
Paul	Gavel
mathieu	Gavin
Benjamin	Gayman
ADRIEN	Gaymon
Vincent	Gayton
Alex	Ge
arthur	Gedeon
Louis	Gee
Baptiste	Gelin
Dylan	Gelinas
Corentin	Gemme
Thibault	Gendreau
jordan	Gendron
Nathan	Housel
Simon	Houx
axel	Houy
Matthieu	Houze
léo	Hu
sebastien	Huard
Aurélien	Huard
victor	Huard
Loïc	Hubel
Rémi	Huberty
Arnaud	Hudon
tom	Hue
david	Huet
Jonathan	Hugo
Damien	Huguenin
Enzo	Huguet
Bastien	Hulet
raphael	Hulett
Mickael	Hulette
François	Hulin
Robin	Hulin
martin	Humble
Dorian	Laliberty
Gabriel	Lalley
tristan	Lallier
Mathis	Lally
Samuel	Lally
Thibaut	Lalonde
charles	Lalumiere
Benoit	Laluzerne
fabien	Lamarche
Florent	Lamarque
Maxence	Lamarque
Cédric	Lamarre
Marc	Lamer
yann	Lamere
Jérôme	Lamey
steven	Lamirand
Mehdi	Lamirande
Gaëtan	Lamon
Erwan	Lamond
Cyril	Lamont
jean	Lamontagne
max	Lamore
rémy	Lamoreaux
yanis	Lamoree
Tony	Lamoreux
Jules	Maple
William	Maran
olivier	Maranville
laurent	Marc
christopher	Marcantel
sylvain	Marceau
Ludovic	Marceaux
Xavier	Marcel
Stephane	Parfait
Tanguy	Paris
mael	Paris
Morgan	Pariseau
Adam	Parisien
Franck	Parisot
Grégory	Parlier
Christophe	Parmentier
Alan	Parquette
antonin	Parran
Mohamed	Merveilleux
